凝光=Ningguang
史莱姆=Slime
留云借风真君=Lưu Vân Tá Phong Chân Quân
北斗=Beidou
落落梅=Quả Dâu Đỏ
提瓦特=Teyvat
丘丘人=Hilichurl
应急食品=Emergency Food
摩拉=Mora
神之眼=Vision
刻晴=Keqing
日落果=Quả Nhật Lạc
深渊法师=Pháp Sư Vực Sâu
七七=Qiqi
琉璃百合=Bách Hợp Lưu Li
盗宝团=Đạo Bảo Đoàn
千岩军=Thiên Nham Quân
香菱=Xiangling
岩王帝君=Nham Vương Đế Quân
坚牢黄玉块=Miếng Hoàng Ngọc Cứng
群玉阁=Quần Ngọc Các
万民堂=Vạn Dân Đường
绝云椒=Ớt Tuyệt Vân
琉璃袋=Túi Lưu Li
言笑=Yanxiao
奥赛尔=Osial
天权=Thiên Quyền
荧=Lumine
荧光=huỳnh quang
玉京台=Ngọc Kinh Đài
归终=Guizhong
派蒙=Paimon
瑶瑶=Yaoyao
璃月=Liyue
甘雨=Ganyu
白术=Baizhu
行秋=Xingqiu
重云=Chongyun
锅巴=Gouba
不卜庐=Bubu
甜甜花=hoa ngọt
绝云间=Tuyệt Vân Gián
飞云商会=Phi Vân Thương Hội
琉璃亭=Lưu Li Đình
新月轩=Tân Nguyệt Hiên
影=Ei
影子=bóng dáng
影响=ảnh hưởng
云堇=Yun Jin
申鹤=Shenhe
